32
16
right
################################
#                              #
#                              #
#                              #
#                              #
#                              #
#           bh                 #
#                              #
#                              #
#                              #
#                              #
#                              #
#                              #
#                              #
#                              #
################################
